{
  "name": "first level",
  "background": "#756266c8",
  "map": [
    [1, 1, 1, 1, 1, 1, 1, 1, 1, 1, 1, 1, 1, 1, 1, 1],
    [1, 1, 1, 1, 0, 8, 1, 17, 1, 0, 0, 0, 1, 0, 2, 1],
    [1, 1, 0, 0, 0, 0, 1, 1, 1, 0, 1, 0, 1, 0, 0, 1],
    [5, 0, 0, 0, 0, 0, 1, 1, 1, 0, 1, 0, 0, 0, 0, 1],
    [1, 0, 0, 0, 1, 1, 1, 1, 1, 0, 0, 1, 0, 0, 0, 1],
    [1, 0, 0, 1, 1, 5, 0, 1, 1, 1, 0, 1, 1, 1, 1, 1],
    [1, 0, 0, 1, 0, 0, 0, 0, 1, 1, 0, 0, 0, 0, 1, 1],
    [1, 0, 0, 1, 0, 0, 1, 0, 0, 1, 1, 0, 0, 0, 0, 5],
    [1, 0, 0, 5, 0, 0, 1, 0, 0, 1, 1, 1, 1, 0, 0, 1],
    [1, 0, 0, 0, 0, 0, 1, 0, 0, 0, 0, 0, 0, 0, 0, 1],
    [1, 0, 0, 0, 0, 0, 1, 0, 0, 0, 0, 0, 0, 0, 0, 1],
    [1, 1, 1, 1, 1, 1, 1, 1, 1, 1, 1, 1, 1, 1, 1, 1]
  ],
  "cameras": [
    {
      "viewDistance": 2,
      "viewAngle": 3,
      "maxRotation": 1,
      "initialRotation": 0.5
    },
    {
      "viewDistance": 2,
      "viewAngle": 3,
      "maxRotation": 1,
      "initialRotation": 0
    },
    {
      "viewDistance": 2,
      "viewAngle": 3,
      "maxRotation": 1,
      "initialRotation": -0.5
    },
    {
      "viewDistance": 2,
      "viewAngle": 3,
      "maxRotation": 1,
      "initialRotation": -0.5
    }
  ]
}
