{
  "name": "first level",
  "background": "#756266c8",
  "map": [
    [1, 1, 1, 1, 1, 1, 1, 1, 1, 1, 1, 1],
    [1, 1, 1, 1, 0, 0, 1, 1, 0, 0, 2, 1],
    [1, 1, 0, 0, 0, 0, 1, 0, 1, 0, 0, 1],
    [1, 0, 0, 0, 0, 0, 1, 0, 0, 1, 0, 1],
    [1, 0, 0, 0, 1, 1, 1, 0, 1, 1, 0, 1],
    [1, 0, 0, 0, 1, 1, 0, 0, 1, 1, 0, 1],
    [1, 0, 8, 0, 0, 0, 0, 0, 0, 0, 0, 1],
    [1, 0, 0, 0, 0, 0, 0, 0, 0, 0, 0, 1],
    [1, 1, 1, 1, 1, 1, 1, 1, 1, 1, 1, 1]
  ]
}
