{
  "name": "first level",
  "background": "#756266c8",
  "map": [
    [1, 1, 1, 1, 1, 1, 1, 1, 1, 1, 1, 1],
    [1, 1, 1, 1, 1, 17, 1, 1, 1, 1, 2, 1],
    [1, 1, 1, 1, 1, 1, 1, 1, 1, 1, 0, 1],
    [1, 1, 1, 1, 5, 1, 1, 1, 1, 1, 0, 1],
    [1, 8, 0, 0, 0, 0, 0, 0, 0, 0, 0, 1],
    [1, 1, 1, 1, 1, 1, 1, 5, 1, 1, 0, 1],
    [1, 1, 1, 1, 1, 1, 1, 1, 1, 1, 0, 1],
    [1, 1, 1, 1, 1, 1, 1, 1, 1, 17, 2, 1],
    [1, 1, 1, 1, 1, 1, 1, 1, 1, 1, 1, 1]
  ],
  "cameras": [
    {
      "viewDistance": 2,
      "viewAngle": 3,
      "maxRotation": 2,
      "initialRotation": 0
    },
    {
      "viewDistance": 2,
      "viewAngle": 3,
      "maxRotation": 2,
      "initialRotation": 1
    }
  ]
}
